WE ./textures/tile006.xpm
SO     ./textures/tile005.xpm
EA    ./textures/tile007.xpm
NO     ./textures/tile003.xpm



F      130,224,170
C 123,45,66


1111111111111111
1010100000010101
1010100000010101
10101000N001010111111111
100000000000000000000001
111111000001111111111111
100000000000000111111111
1111110000011111
1000000000000001
1000000000000001
11111111111111111111111111111
