NO ./textures/tile003.xpm
SO ./textures/tile005.xpm
WE ./textures/tile006.xpm
EA ./textures/tile007.xpm

F 130,224,170
C 225,30,170

1111111111111111
1010100000010101
10101111D1111101
1010100000010101
1000000000000001
11111100N0011111
1000000000000001
11111111D1111111
1000000000000000
1111111111111111
