NO ./textures/tile003.xpm
SO ./textures/tile005.xpm
WE ./textures/tile006.xpm
EA ./textures/tile007.xpm

F 130,224,170
C 225,30,0


111111111111
100000000001
100100010001
100110000001
101000000101
100000000001
100000N00001
101000000101
100000000001
100100001001
100000000001
111111111111