NO ./textures/tile003.xpm
SO ./textures/tile005.xpm
WE ./textures/tile006.xpm
EA ./textures/tile007.xpm

F 130,224,170
C 225,30,0

111111111111111111111111111
100000000000000000000000001
100001001000000001000000001
100010000000000000010000001
1000000000000N0000000000001
100100000000000000100000001
100000000000000000000000001
100000001000001000000100001
1000000000000000000000000011
1111111111111111111111111111