1111111111111111
10101000S0010101
1010100000010101
1010100000010101
1000000000000001
1111110000011111
1000000000000001
1111110000011111
10000000E0000001
11111111111111111
